{
  "도움": 0,
  "친구": 1,
  "가족": 2,
  "감사": 3,
  "안녕": 4,
  "사랑": 5,
  "학교": 6,
  "병원": 7
}